radiounumanele.com	False
garage-autodep.com	False
adbagency.com	False
timelesspiece.eu	False
watchesbestdeals.com	False
nibiru.com.hk	False
longinesfrance.xn--nike-tg9gs23cos3b.net	False
ajs.com.es	False
paginasamarillasec.com	False
airforceone-ny.tripod.com	False
brujas.nyc	False
vinstore24.ru	False
wikipost.ga	False
wholesale-s9vvdm0d.ga	False
fashionpress.it	False
schullin.at	True
luxshery.com	False
microwinner.cn	True
mycorner.fr	True
allboatsavenue.com	False
m.kenh14.vn	False
noobn6.com	False
pinktradition.blogspot.com	False
bigbigwatch1.blog.hexun.com	False
ovianet.com	False
imusttravel.ca	False
duhallowwebdesign.com	True
jollymagazine.com	False
news.gia114.com	False
inwonderland.co	True
importir-7vnsmvrq.ga	False
rosetteismyname.wordpress.com	False
watcheswe.blogspot.com	False
26312607.com	False
balili.com.ua	False
159.203.76.46	False
escolavitae.com	False
scarecrow-prez.blogspot.com	False
granadis.com	False
cantinamundo.fr	False
artglassstudio.com.au	True
vavitriathlonclub.com	False
watchdodo.com	False
40rz.com	False
shelbyvillemonument.com	False
chanel_5844310.molobi.com	False
andrea-casanova.com	False
sss.style-tips.com	False
passage-projects.com	False
iskraufa.ru	False
kusamivn.com	False
borsetta-channel.com	False
chanel.hitss.ru	False
thejewelleryinsider.net	False
blindssi.blinds-shops.com	False
lesyzbiroh.cz	True
avaclip.com	False
cinemanet.info	False
1.liangtzi.net	False
goedkoophublotbigbangking.blogspot.com	False
modne-hodinky.blogspot.com	False
libertop.ru	True
zscjmy.com.cn	True
brandstory.baike.com	True
chrysalischarters.com	False
elare.pl	False
dreamworks.wikia.com	True
zbw666.com	False
vinshop24.ru	False
epaper.hilizi.com	False
paginasdigital.es	False
hbzczb.cn	False
melanielyon-ramonescobosa.com	False
122.10.50.145	False
vogue.com.tw	False
aidid.cn	True
qishan.soshaw.com	False
pwindata.com	True
watch-sale-stok.ru	True
time-brend.ru	False
pforpieces.com	False
393edu.org	False
niu9999.com	False
filmpunkten.se	True
chanel.52watch.com	False
blog.miya1975.com	True
archyworldys.com	False
zeleb.mx	False
zbbsweb.com	False
cassettiorologi.it	False
sikashop.avablog.ir	False
zipe.fr	False
industry-75iitbwp.ga	False
catwalkkitty.co.uk	False
sieuthidonghohieu.com	False
odadonna.xyz	False
izzaf.livejournal.com	False
3711862.blog.hexun.com.tw	True
ctkcathedral.org	False
videoartis.xyz	False
yuepai.wang	False
guitar.co.uk	False
londonmonumentco.com	False
magazine.afr.com	True
indidi.co.uk	False
za-st.ru	True
m.niwotashow.com	True
h2.itlweb.com	True
mickspizzeria.com	False
fakechanelwatchesj12.wordpress.com	True
2017mixi-free.com	False
lescarnetsdaurelia.com	True
laridon.fr	False
servingnotice.com	False
ssandt.org	False
becksmithhollywood.com	False
radiantglamor.com	False
michaelkorscase.tumblr.com	False
shichikaicom.wixsite.com	False
qa.fashionnetwork.com	False
cronememorials.com	False
hauteinhabit.com	True
irsaindiana.org	False
yu14913.pixnet.net	False
watchsupercopy.com	True
gold110.jp	False
hehdesigns.tumblr.com	False
filmski.net	False
luxeglobal.com	False
vip-brand1.ru	False
bameshi.com	True
202.121.168.9	False
god2016m.ru	False
articleshost.com	False
trianglekiosk.com	False
se.fashionnetwork.com	False
baidu.com	False
replicadictionary.com	False
chanel_5502079.molobi.com	False
noobj12fk.com	False
nonidesign.over-blog.com	False
fashionenews.com	True
world-of-pany.blogspot.com	False
aaa.bmall315.com	False
shops-phone.com	False
price-chanel.52watch.com	False
apurseforum.com	False
codedwap.com.ng	False
xn--mnqx6j97z9wcs8fq6r.xn--tfrxfu2p.name	False
digixstreamusa.com	False
digiala.ir	False
sistime.ru	True
zbkb.com	False
filmreviewonline.com	False
universalwristwatch.com	False
ckbabes.com	False
sveg.org.cn	True
elmstrom.blogg.se	False
hero000bd.ehoh.net	False
premiertaxfree.cn	True
hungwei.looker.tw	False
xn--chopard-db7mf4qsp7ilfraekkxli.xn--nike-tg9gs23cos3b.net	False
enlightenedage.blogspot.com	False
trendingsale.com	False
watch.listitems.info	False
dontbalkbaseballshop.com	False
smelink.se	False
m.wroclaw.plan.pl	False
azcache.com	False
arsip.forumbebas.com	False
chupsanpham.com.vn	False
philippebanks.com	False
thecooluxury.com	False
opera-kinbido.com	False
naktigone.lt	False
buy-8511.ir	False
gannon.com.vn	True
chanel.granadis.com	True
joyeriasaneloy.com	False
de5igner.myshopify.com	True
nasimvideo.ir	False
santroxshop.com	False
filmering.at	False
chanel1.best-gooods.ru	False
trc.vg	False
kal-mor.com	False
festivalofflavour.com.au	False
channel2.hitsale.net	False
ebooking24.com	True
elenka.ru	True
repwatchesuk.com	True
bjr027.com	False
bestseller.in.ua	False
masterenfilosofia.es	False
javanmedia.ir	False
planbet.es	True
laumaclatubul.cf	False
media.gunaxin.com	False
croatia-stuttgart.de	False
1designfree.com	True
thestchristopherschool.co.uk	False
carnabysjewellers.co.uk	False
online.abacus.coop	False
lilianjewelry.com	True
film.it	False
c.trklp.ru	False
papote.net	False
pilatescheshire.guru	False
alerttrainers.com	False
rahatkharid.ir	False
nexfilm.ir	False
879wr.com	False
eleanor1011.pixnet.net	False
kairosstore.com	False
supa-kopi-cartier.com	False
wer3414.pixnet.net	False
exspace.pl	False
jvnan.com	False
shopsearchs.com	False
afzone.blog.ir	False
mydarlinglife.com	False
thecccinc.org	False
w1236155.seesaa.net	False
lahummatbayli.com	False
ssnnshop2017.com	False
luotuohuwai.org	False
racketlon.at	False
scubafroggy.fr	True
trajly.cz	False
situartes.es	False
nicolelmedia.blogspot.com	False
tylerchoi8.mall.yorkbbs.ca	False
kiemtoan.com.vn	False
interviewrussia.ru	True
thamgia.net	True
tokiwokizamu.com	False
anhnghethuathanoi.blogspot.com	False
cms.harpersbazaar.com.hk	False
new.femina.ch	False
facebook.com	True
jyhhdp.com	False
xikili.com	False
watche.tcso.cn	True
vntourism.cn	False
bevalenteoficial.wordpress.com	False
monicatlmh03.pixnet.net	False
cchere.com	True
mvnvh.com	False
robotclass.ru	False
u-labs.de	False
sss.tsunokakushi.com	False
interbag.com.ua	False
ika-mode.pinger.pl	False
lofficiel.vn	False
qlspj.com	False
orologisvizzeri.com	True
debajodelreloj.com	True
top-optom.ru	False
zijin.mall.yorkbbs.ca	False
stilvagoon.com	True
tedxmontevideo.org	False
arcashop.ir	False
aj12watch.com	False
tomucho.com	False
chikakopote.blog.fc2.com	False
imoyo.com.cn	False
homeminimalis.com	False
chanel-stok.ru	False
xjywx.com	False
supershoppingmaster.blogspot.com	False
thedarlingdetails.blogspot.com	False
checksoranva.getenjoyment.net	True
copy59.com	False
boswellmonuments.com	False
009520.com	False
bbkz.bid	False
0202003.com	True
watchespedia.com	True
lkbkspro.eiger-agency.lookbooks.me	True
playen3.indexbuzz.net	False
kokwatch.com	True
prosupportsystems.com	False
swisswatchesreviews.com	False
watchesforwomen.co.uk	False
ballerwatches.com	False
zjahhj.com	False
spzswang.com	True
smartshopity.co.uk	False
asianguesthouse.com	False
122.10.50.57	False
hkeasychat.com	True
houmania.com	False
channel2.shopsale.pro	False
aicopy65.com	True
wealthisme.com	False
campaign.hk.mensuno.asia	False
worldscreen.com.tw	False
easy2dial.in	False
wisdreams.com	True
hongkongtudor.xn--eus26d31nh24a.com	False
caronmemorial.com	False
4star.niloblog.com	False
bloemist-alexandrium.nl	False
agreellen.pixnet.net	False
originwfjeceu-www.chanel.com	False
art-quest.ru	False
semadihuancayo.com	True
hdwon.com	True
1001dicas.net	False
deepforestcomic.com	False
xn--80a8aqs.xn--80aoh.xn--b1amgoeo.com	False
watchesuser.com	True
luxuryauthentichandbags.eu	False
crocuscitymall.ru	False
musicca.host	False
56vod.net	False
ictf2016.ieice-europe.org	True
bagll.net	True
akimoto-rie.blogspot.com	False
ceasuri.shop	True
ouxiangpai.com	False
pinkribbonbreakfast.at	False
leisure1937.rssing.com	False
demo2.aliplugin.es	True
ouietconsequences.fr	False
ibieshop2.blogspot.com	True
sunwardflag.com	False
handbagshows.site	False
68.leverenzautomotive.com	False
gugo.info	False
claxfactor.blogspot.com	True
195.154.205.150	False
eieful.exblog.jp	False
copykate.blogspot.com	True
dbhr.bid	False
cswatchco.com	False
time-brend2.ru	False
luxgroupltd.ru	False
usnavycrew.com	True
ddtfsb.com	False
69.16.194.131	True
wishesjewelry.net	False
thepoolscene.com	False
blog.lastelier.com	False
kulthit.de	True
mylino.ir	True
blakfacts.blogspot.com	False
bestwatchesdeals.co	False
thelibrarygroup.be	True
gmt2013.com	False
kafgroup.se	True
bagnopiero.it	False
vintagevicar22.wordpress.com	False
ebay.com	True
replicamontre.fr	True
weilai178.com	True
waltzingm.com	False
cartierks.xn--nike2012-604r392ccs4elz0a.com	False
xca351.pixnet.net	False
pellegrin-et-fils.com	False
bagsreplicas.top	True
122.10.50.144	False
sweetembroideryfree.com	False
zhhbds.com	False
ccthere.com	True
lofficielmalaysia.com	False
spielegasse.de	False
flowers.cheerclassics.com	True
ictf2015.ieice-europe.org	False
lifestyleagent.nl	False
icon-icon.fr	False
embassy.ch	True
kristenfilm.com	False
achicdirection.com	False
reluxe.ca	False
1chanel.2015brend.ru	True
kompas4.ru	True
rossettoeguai.it	False
thegioicauca.com	False
dcscam.com	False
nacd.co.uk	False
cacheepr.wordpress.com	False
xn--80aalbng9atkk.xn--p1ai	False
stefanie-stoelting.de	True
parentpreviews.com	False
backstagetales.com	False
hollfelder.de	False
innateskin.com	False
fashionbrand.org	False
dandasmetals.mall.yorkbbs.ca	False
dev.harpersbazaar.my	True
cheapchanelsale2015.com	False
chaneltokeikaitori.com	False
xayxbj.com	False
xintuosc.com	False
fullhd-roliki.ru	False
so-copy.com	True
melnandutmacammanalagi.blogspot.com	True
irischan.blog124.fc2.com	False
uhren-swiss-rolex-daytona-hot.blogspot.com	False
copy016.com	True
replicaswatch.top	False
gapwet.xyz	False
xn--22cej8ezaasjc5ef5fgbb5bycxovcjo.com	True
lexingtongraniteco.com	False
infos-75.com	False
jetrichonline.com	False
bluray-disc.de	False
wwwm.com.tw	True
chasy1-chanel.parfumes.pp.ua	False
projetoempreendedor.com	True
fyndson.se	False
rb-triangle.sakura.ne.jp	False
slashitmag.com	False
fanaticsworldwide.com	False
fashionwatchesshop.eu	False
cinemerida.blogspot.com	False
chanelsonlineshop.de	False
shopmenow.blogsky.com	False
sandau.edu.cn	True
labutaca.net	False
nostime.com	True
hnpcorp.net	False
know-it-ebog.dk	True
70biao.com	False
m.ddtfsb.com	True
gabris.eoldal.hu	False
gallaghermonuments.com	True
lombard-premium.com.ua	True
daytonarolex.top	False
swiss-luxe24.ru	False
louisvuittonreplicabag.com	False
geotaboretmi.gq	False
liehunwang.com	False
parkciftlik.com	False
takebagshome.us	True
ovum.org.pl	True
monpetitvendome.fr	False
kalashop.niloblog.com	True
cineclub.de	False
dicasdefilmes.com.br	False
niwotashow.com	False
kinbido.info	False
kamil-karamali.com	False
ujh51jz16a.pixnet.net	False
mdh-vip.com	False
yfhpif.myday.cn	False
vloggest.com	False
catlezzie.gq	False
customjewelrymare.com	False
pinky-st.skr.jp	False
barpaly.com	False
paulineferrari.com	False
teafor.xyz	True
zaloro.com	False
bdalbum.com	False
homegallerystores.com	False
kanaja.in	False
davids-deco.com	False
m.5noob.com	False
bursamusik.dfakemp3.com	False
gpdingunut.wordpress.com	False
lady.51802.com	False
embroiderybella.com	False
gift5star.com	True
gzmb99.com	False
hairstyleday.blogspot.com.ng	False
mapeli.com	False
luxurystation.vn	False
bullrichcampos.com.ar	True
1stcopychanelflapbags.com	False
shopjpk7.com	False
tos.shabri.ru	False
5.39.90.27	False
hittovar24.blizko.kz	False
psimovie.com	False
xzsbzx.com	False
joseweb.webr.ly	False
hangaysaat.com	False
topthingz.com	False
japex.ru	False
luxurymarkets.me	True
catwalkkitty.blogspot.com	False
harpersbazaar.pl	False
rossmanning.com	False
europa-gold-paris.com	False
wer3413.pixnet.net	False
timezite.com	True
wefs125.pixnet.net	False
freakcart.com	False
begmarkq.cf	False
sikashop.ir	False
goud-smederij.nl	False
kalaashop.javanblog.ir	False
rolexwatchesforsale.top	False
rodlme.com	False
m.imaginea.info	False
bagfashionews.com	False
myembroideryfree.com	False
sfanytime.com	False
